name	email	company	city
Ada Jefferis	adhere@msn.com	Hyundai	Warsaw
Hilario Avallone	bbirth@icloud.com	Verizon Communications	Dublin
Leeann Husbands garyjb@yahoo.com	Mercedes-Benz	Birmingham
Gerald Barcus	portele@live.com	Audi	Lyon
Carylon Poindexter	ilikered@msn.com	Johnnie Walker	Edinburgh
Enid Petzold	louise@aol.com	Moët et Chandon	Oslo
Verline Blust	sassen@gmail.com	Sony	Amsterdam
Amina Blunk	dobey@optonline.net	Global Gillette	Paris
Beverley Tarnowski	sethbrown@aol.com	Pampers	Frankfurt
Gena Crigger	tristan@me.com	Corona	Riga
Chia Combes	tubajon@verizon.net	Gucci	Istanbul
Ching Kilmer	jkegl@sbcglobal.net	HSBC	Zagreb
Yoshiko Mccomb	itstatus@yahoo.com	Sprite	Saint Petersburg
Nena Manson	russotto@optonline.net	Nescafé	Dnipro
Niki Markell	reeds@verizon.net	VISA	Belgrade
Elma Hauck	gknauss@hotmail.com	Apple Inc.	Odessa
Pamila Tudor	lamprecht@comcast.net	Panasonic Corporation	Cologne
Roselyn Jeffreys	chrisk@msn.com	Facebook, Inc.	Samara
Kaycee Bellone		pappp@yahoo.ca	Adobe Systems	Brussels
Boris Hersom	jipsen@yahoo.ca	Hewlett-Packard	Prague
Cristal Burnside	rbarreira@gmail.com	Johnson & Johnson	Munich
Lory No	mwilson@yahoo.ca	Louis Vuitton	Milan
Etsuko Melgarejo	mcraigw@sbcglobal.net	PepsiCo	Barcelona
Odis Elem	kingma@icloud.com	Hermès	Vienna
Winnie Falcone	vlefevre@live.com	Beko	Bucharest
Maryjo Royster	openldap@sbcglobal.net	United Parcel Service	Zagreb
Dotty Remo	parasite@gmail.com	Pizza Hut	Frankfurt
Delinda Liang	linuxhack@icloud.com	The Walt Disney Company	Vilnius
Latina Scovil	oracle@verizon.net	Siemens AG	Naples
Han Hora	hllam@yahoo.ca	Coca-Cola	Volgograd
name	email	company	country
Lenore	dapibus.ligula@eu.co.uk	Imperdiet Consulting	Estonia
Suki	iaculis.quis.pede@vestibulumMauris.co.uk	Luctus Foundation	French Southern Territories
	vel.convallis.in@maurisblandit.org	Non Quam LLP
Idona	sed@nondapibus.ca	Pellentesque Ut Ipsum Incorporated	Kiribati
Fredericka	nunc@magnaLoremipsum.ca	In Consectetuer Company	Puerto Rico
Haviva	nisi.nibh@fermentumarcu.com	Sit Amet PC	Liechtenstein
Mercedes	Praesent@Nulla.edu	Dolor Sit Foundation	Sri Lanka
Aurelia	sit@urnaUt.ca	Augue Ac Limited	Cayman Islands
Sierra	Sed.malesuada.augue@semmollis.ca	Diam LLC	Malta
Ebony	consectetuer.adipiscing@augueporttitor.edu	Semper Industries	Venezuela
Whoopi	Quisque@ipsumdolor.com	Gravida Ltd	India
Sybill	massa@malesuadaiderat.org	Sodales
Cara	posuere.enim@idenimCurabitur.com	Aliquam Enim Nec Ltd	Armenia
	mollis.vitae.posuere@Vestibulumante.edu	Integer Vulputate LLP	Serbia
Violet	dolor.tempus@Donecatarcu.edu	Semper Erat Associates	Comoros
Ria	ultricies.ligula@lorem.com	Ante Ipsum Inc.	Venezuela
Haviva	auctor.nunc.nulla@Phasellus.edu	Integer PC	Bosnia and Herzegovina
Xandra	tempus@turpisAliquam.edu	Suspendisse Industries	Greece
Clio	quam@Nuncsed.edu	Phasellus Dolor Elit Incorporated	Marshall Islands
Guinevere	tellus.justo@tortordictum.co.uk	Dapibus Id Blandit Ltd	Malaysia
Jenette	Nam.nulla@cursusIntegermollis.ca	Et Tristique Incorporated	Bermuda
Kristen	enim@scelerisquescelerisque.net	Id Institute	British Indian Ocean Territory
Lydia	vehicula.Pellentesque@lobortismaurisSuspendisse.co.uk	Quam Curabitur Consulting	Mayotte
Selma	ac.ipsum@Vivamusrhoncus.org	Rhoncus Proin Company	Romania
Abigail	augue.id@dictumsapienAenean.edu	Ullamcorper Viverra Maecenas LLC	Ireland
Leilani	Donec.nibh.Quisque@lobortisrisus.org	Vel Mauris Integer Foundation	Serbia
Dacey	Nullam@accumsan.com	Ut Aliquam Iaculis Associates	Madagascar
Gloria	Aliquam@semperetlacinia.edu	Cursus Corp.	Chad
Kiara	augue.Sed.molestie@etipsum.ca	Elementum At Consulting	Cameroon
Desirae	ligula.Donec@pharetrafelis.edu	Aliquet Inc.	Guernsey
Noel	Quisque@ideratEtiam.co.uk	Orci Corporation	New Caledonia
Maggie	Maecenas.libero.est@anunc.co.uk	Nulla Integer Incorporated	Canada
Tallulah	ridiculus.mus@nec.edu	Amet Diam Company	Switzerland
Alyssa	hendrerit.neque@dapibusrutrum.co.uk	Dui Semper Et Foundation	Sweden
Amanda	lorem@magnaSedeu.net	Ipsum Inc.	Guam
Sybill	velit.eu.sem@vulputatemauris.org	Tempor Consulting	Macedonia
Maia	feugiat.non.lobortis@Integeraliquamadipiscing.ca	Consectetuer Ltd	Togo
Libby	Nam@Sedcongue.co.uk	Praesent Luctus Corp.	Ireland
Evangeline	id@Fuscefermentum.com	Et Ultrices LLC	Tunisia
Quail	Mauris@nondui.net	Vivamus Nibh Company	Puerto Rico
Madeson	arcu.imperdiet.ullamcorper@commodo.edu	Morbi PC	Botswana
Unity	lectus.convallis.est@diam.com	Consectetuer Euismod Est Incorporated	New Caledonia
Dorothy	Vivamus@elit.ca	Ut Mi Corporation	Gambia
Priscilla	a@egetdictum.com	Nunc Quis Arcu Ltd	Belize
Eugenia	mauris@lacusEtiam.ca	Egestas LLC	Nigeria
Anastasia	neque.Nullam@malesuadafamesac.co.uk	Eleifend Non Dapibus Limited	Montserrat
Signe	ipsum.nunc@MorbimetusVivamus.ca	Penatibus Et Incorporated	Turkey
Kylie	eget.metus@lacusMauris.net	Penatibus Et Consulting	Afghanistan
Kirestin	mauris.ipsum@Aeneanegestas.org	Congue Elit Corp.	Djibouti
Inez	Curabitur.ut@Quisquefringilla.org	Dignissim Company	Australia
Mary	quam.dignissim@ipsumnuncid.ca	Etiam Vestibulum Massa Incorporated	Ghana
Hyacinth	massa@posuerevulputate.com	Nulla Integer Inc.	Russian Federation
Reagan	eget.dictum@Nuncquis.org	Sed Eu Limited	Sint Maarten
Madison	ante.dictum.mi@sitamet.ca	Ornare In Institute	Samoa
Ramona	Sed.eu.nibh@magnaSuspendisse.com	Dui In LLP	Gabon
Felicia	non@euismodurna.edu	Eros Turpis Non Inc.	Guinea-Bissau
Kellie	Mauris@ante.net	Feugiat Company	Kazakhstan
Kristen	sem.magna@magnaUt.org	Cursus Et Industries	Sao Tome and Principe
Olivia	Duis.risus@Namacnulla.com	Rutrum Non Hendrerit Industries	Brazil
Denise	vitae.erat.vel@vulputateduinec.org	At Sem Institute	Palau
Buffy	mauris@cursusa.org	Nibh Phasellus Nulla Foundation	Guyana
Sonia	viverra.Maecenas.iaculis@orcitincidunt.net	Donec Egestas Corp.	Cuba
Octavia	Etiam.ligula@Aliquamornarelibero.org	Vitae Consulting	Togo
Phoebe	lorem.ut@dui.co.uk	Sollicitudin Industries	Belarus
Jolie	dolor@molestiesodalesMauris.org	Proin Velit Sed Institute	Cook Islands	27062438
Kendall	mi.ac.mattis@Donecvitae.org	Auctor Velit Aliquam Ltd	Tanzania
Iliana	Nunc.laoreet.lectus@veliteusem.ca	Gravida Molestie Corporation	Lebanon
Octavia	et@imperdietornare.net	Proin Corp.	Northern Mariana Islands
Sigourney	euismod@sagittisfelis.org	Scelerisque Institute	Guadeloupe
Suki	velit.eget.laoreet@Maurismagna.org	Mollis Limited	Bouvet Island
Illana	quis.massa@neque.org	Sapien Incorporated	Uzbekistan
Janna	lacinia@turpisnonenim.net	Eu PC	Bangladesh
Piper	neque.venenatis.lacus@Donec.org	Arcu Imperdiet Ullamcorper Inc.	Tuvalu
Hiroko	Aliquam@milaciniamattis.net	Et Ipsum LLP	Lesotho
Shana	egestas.Aliquam.fringilla@Donecnonjusto.ca	Aenean Sed Limited	American Samoa
Anastasia	magna@faucibuslectus.net	Nullam Feugiat Placerat Incorporated	Honduras
Maya	Suspendisse.commodo@eu.com	Fermentum Arcu PC	Malaysia
	non.quam@Namporttitor.edu	Et Associates	United States
Kitra	nonummy.ac.feugiat@nonlorem.com	Eu Ltd	Monaco
Hollee	Donec.egestas@leo.org	Ut Company	Iceland
Caryn	vulputate@Morbi.org	Nisi Magna Sed Limited	Djibouti
Willa	Nulla.eu.neque@in.ca	Fringilla Porttitor Institute	Christmas Island
Autumn	a@Morbi.com	Cursus Et Foundation	Guadeloupe
Gwendolyn	laoreet.posuere.enim@vehicula.edu	Phasellus Vitae Corporation	Uzbekistan
Willa	Morbi.accumsan@ultricesiaculis.com	Diam Dictum Sapien Incorporated	Hungary
Jemima	eget.odio@anteiaculisnec.net	A PC	Tajikistan
Cora	eu.lacus@etlibero.org	Luctus Curabitur Company	Belarus
Emma	risus.Duis@nunc.edu	Lobortis Class Aptent Industries	Sudan
Inez	malesuada@nuncInat.net	Etiam PC	Liberia
Scarlett	vel@mollisvitaeposuere.net	Dolor Donec Consulting	Mongolia	26061928
Kylee	ac.turpis@dictumeleifend.com	Litora Torquent PC	Gabon
Quin	Phasellus.fermentum.convallis@amagna.co.uk	Ut Nec PC	Guernsey
Imani	morbi.tristique.senectus@sedfacilisis.edu	Accumsan Industries	United States
Gemma	cursus.Nunc@Aliquamfringilla.com	Quam Quis Diam PC	Iran
Dai	dolor@aliquameu.co.uk	Odio Etiam Ligula Foundation	Mali
Madaline	id.nunc.interdum@mauris.net	Odio Vel Est Incorporated	Zimbabwe
Nerea	turpis.egestas@egetipsum.ca	Urna Et Arcu PC	Bonaire, Sint Eustatius and Saba
Teagan	sapien.gravida.non@risusDonecnibh.org	Odio Associates	Curaçao
Desirae	Morbi.sit@tristique.net	Nunc Nulla Vulputate Inc.	Côte D'Ivoire (Ivory Coast)
Amelia	eget@Aliquamrutrum.net	Odio Institute	Virgin Islands, British

